¦¦¦¦¦¦¦¦¦¦¦¦¦¦¦¦¦¦¦¦¦¦¦¦¦¦¦¦¦¦¦¦¦¦¦¦¦¦¦¦¦¦¦¦¦¦¦¦¦¦¦¦¦¦¦¦¦¦¦¦¦¦¦¦¦¦¦¦¦¦¦¦¦¦¦¦¦¦¦¦¦¦¦¦¦¦¦¦¦¦¦¦¦¦¦¦¦¦¦¦¦¦¦¦
S          ¦¦                                       ¦                                               ¦¦ ¦
¦¦¦¦¦¦¦¦¦¦ ¦¦ ¦¦¦¦¦¦¦¦¦¦¦¦¦¦¦¦¦¦¦¦¦¦¦¦¦¦¦¦¦¦¦¦¦¦¦¦¦ ¦¦¦¦¦¦¦¦¦¦¦¦¦¦¦¦¦¦¦¦¦¦¦¦¦ ¦¦¦¦¦¦¦¦¦¦¦¦¦¦¦¦¦¦¦¦¦ ¦¦ ¦
¦                             ¦ ¦¦¦¦¦¦                                        ¦¦                 ¦¦ ¦¦ ¦
¦ ¦¦¦¦¦¦¦¦¦¦¦¦¦¦¦¦¦¦¦¦¦¦¦¦¦¦¦ ¦        ¦¦¦¦¦¦¦¦¦¦¦¦¦¦¦¦¦¦¦¦¦¦¦¦¦¦¦¦¦¦¦¦¦¦¦¦¦¦¦¦¦ ¦¦¦¦¦¦¦¦¦¦¦¦¦¦¦ ¦¦ ¦¦ ¦
¦      ¦  ¦                  ¦ ¦¦¦¦¦¦¦¦¦¦                                        ¦¦   ¦   ¦   ¦¦ ¦¦ ¦¦ ¦
¦ ¦¦¦¦¦¦ ¦¦ ¦¦¦¦¦¦¦¦¦¦¦¦¦¦¦¦ ¦ ¦¦¦¦¦¦¦¦¦¦ ¦¦¦¦¦¦¦¦¦¦¦¦¦¦¦¦¦¦¦¦¦¦¦¦¦¦¦¦¦¦¦¦¦¦¦¦¦¦¦¦¦ ¦   ¦   ¦    ¦¦ ¦  ¦
¦           ¦¦            ¦¦ ¦                         ¦ ¦¦                       ¦ ¦¦¦¦¦¦¦¦¦¦¦¦¦¦¦ ¦ ¦¦
¦¦¦¦¦¦¦¦¦¦¦¦¦¦ ¦ ¦¦¦¦¦¦¦¦¦¦¦ ¦¦¦¦¦¦¦¦¦¦¦ ¦¦ ¦¦¦¦¦¦¦¦¦ ¦¦    ¦¦¦¦¦¦¦¦¦¦¦¦¦¦¦¦¦¦¦ ¦      ¦            ¦ ¦¦
¦              ¦                         ¦¦          ¦¦¦¦¦¦¦¦¦¦¦¦¦¦¦¦¦¦         ¦¦¦¦¦¦¦¦ ¦¦¦¦¦¦¦¦¦¦ ¦ ¦¦
¦¦¦¦¦¦¦¦¦¦¦¦¦¦¦¦¦¦¦¦¦¦¦¦¦¦¦¦¦¦¦¦¦¦¦¦¦¦¦¦¦¦¦¦¦¦¦¦¦¦¦¦¦¦¦              ¦¦ ¦¦¦¦ ¦¦¦¦¦¦      ¦¦         ¦ ¦¦
¦                                                       ¦¦¦¦¦¦¦¦¦¦¦¦ ¦¦¦¦¦¦¦¦¦¦¦¦   ¦¦¦¦¦¦¦¦¦¦¦¦¦¦¦   ¦¦
¦ ¦¦¦¦¦¦¦¦¦¦¦¦¦¦¦¦¦¦¦¦¦¦¦¦¦¦¦¦¦¦¦¦¦¦¦¦¦¦¦¦¦¦¦¦¦¦¦¦¦¦¦¦¦¦           ¦              ¦¦ ¦ ¦           ¦¦¦¦¦
¦             ¦   ¦             ¦                        ¦¦¦¦¦¦¦¦¦  ¦¦¦¦¦¦¦¦¦¦¦¦¦¦       ¦¦¦¦¦¦¦¦¦     ¦
¦¦¦¦¦¦¦¦¦¦¦¦¦ ¦ ¦ ¦ ¦ ¦¦¦¦¦¦¦¦¦ ¦ ¦¦¦¦¦¦¦¦¦¦¦¦¦¦¦¦¦¦¦¦¦¦¦         ¦                ¦¦¦ ¦¦¦¦¦¦¦¦   ¦¦¦¦ ¦
¦   ¦       ¦ ¦ ¦ ¦ ¦          ¦               ¦¦¦¦¦¦¦¦¦¦ ¦¦¦¦¦¦¦¦ ¦¦¦¦¦¦¦¦¦¦¦¦¦¦¦¦   ¦         ¦    ¦ ¦
¦ ¦¦¦ ¦¦¦¦ ¦¦   ¦ ¦ ¦¦¦¦¦¦¦¦¦¦¦¦ ¦¦¦¦¦¦¦¦¦¦¦¦¦¦¦                                   ¦¦   ¦¦ ¦¦¦¦¦¦¦¦¦ ¦ ¦
¦     ¦     ¦ ¦¦¦ ¦                              ¦¦¦¦¦¦¦¦¦¦¦¦¦¦¦¦¦¦¦¦¦¦¦¦¦¦¦¦¦¦¦¦¦ ¦¦ ¦¦¦¦      ¦   ¦  ¦
¦¦¦ ¦¦¦¦¦¦¦¦¦ ¦ ¦ ¦¦¦¦¦¦¦¦¦¦¦¦¦¦¦¦¦¦¦¦¦¦¦¦¦¦¦¦¦¦¦¦¦                    ¦¦        ¦ ¦¦ ¦¦¦¦¦¦¦¦¦ ¦ ¦¦  ¦¦
¦   ¦           ¦                                   ¦¦¦¦¦¦¦¦¦¦¦¦ ¦¦ ¦¦ ¦¦¦¦¦¦¦¦¦ ¦ ¦          ¦ ¦ ¦¦ ¦¦¦
¦ ¦¦¦ ¦¦¦¦¦¦¦ ¦ ¦¦¦¦¦¦¦¦¦¦¦¦¦¦¦¦¦¦¦¦¦¦¦¦¦¦¦¦¦¦¦¦¦¦¦¦¦           ¦ ¦ ¦¦ ¦¦ ¦¦¦¦   ¦ ¦ ¦¦¦¦¦¦ ¦ ¦ ¦ ¦¦   ¦
¦     ¦   ¦   ¦                              ¦¦       ¦¦¦¦¦¦¦¦¦ ¦ ¦ ¦¦ ¦¦      ¦ ¦ ¦ ¦      ¦ ¦ ¦ ¦¦ ¦ ¦
¦ ¦¦¦¦¦¦¦ ¦ ¦ ¦¦¦¦¦¦¦¦¦¦¦¦¦¦¦¦¦¦¦¦¦¦¦¦¦¦¦¦¦¦ ¦¦ ¦¦¦¦¦       ¦¦¦ ¦ ¦ ¦¦ ¦¦¦¦¦¦¦¦¦ ¦ ¦ ¦¦¦¦¦¦¦  ¦   ¦¦ ¦ ¦
¦ ¦ ¦   ¦   ¦              ¦                      ¦   ¦¦¦¦¦ ¦¦¦ ¦ ¦  ¦ ¦¦       ¦¦ ¦ ¦     ¦ ¦¦¦¦¦¦¦ ¦ ¦
¦ ¦   ¦  ¦¦¦¦¦¦¦¦¦¦¦¦¦¦¦¦¦¦¦¦¦¦¦¦¦¦¦¦¦¦¦¦¦¦¦¦¦¦¦¦¦¦¦¦¦¦¦¦¦¦  ¦¦ ¦ ¦¦ ¦ ¦¦ ¦¦¦¦¦¦¦¦ ¦¦¦ ¦¦¦ ¦         ¦ ¦
¦ ¦¦¦ ¦¦                    ¦                             ¦¦  ¦ ¦ ¦¦ ¦ ¦¦              ¦ ¦ ¦¦¦¦¦¦¦¦¦¦¦ ¦
¦ ¦   ¦¦¦¦ ¦¦¦¦¦¦¦¦¦¦¦¦¦¦¦¦ ¦ ¦ ¦¦¦¦¦¦¦¦¦¦ ¦¦¦¦¦¦¦¦¦¦¦¦¦¦  ¦¦ ¦ ¦ ¦¦ ¦ ¦¦¦¦¦¦¦¦¦¦¦¦¦¦¦¦¦ ¦ ¦           ¦
¦ ¦ ¦¦¦                   ¦ ¦ ¦ ¦        ¦              ¦¦   ¦¦     ¦¦                   ¦ ¦ ¦¦¦¦¦¦¦¦¦¦¦
¦ ¦   ¦¦¦¦¦¦¦¦¦¦¦¦¦¦¦¦¦¦¦ ¦¦  ¦   ¦¦¦¦¦¦¦¦¦¦¦¦¦¦¦¦¦¦¦¦¦   ¦¦¦¦¦¦¦¦¦¦¦¦¦¦¦¦¦¦¦¦¦¦¦¦¦¦¦¦¦¦¦¦ ¦ ¦         E
¦   ¦                   ¦    ¦ ¦¦                      ¦¦                                  ¦   ¦ ¦¦¦¦¦¦¦
¦¦¦¦¦¦¦¦¦¦¦¦¦¦¦¦¦¦¦¦¦¦¦¦¦¦¦¦¦¦¦¦¦¦¦¦¦¦¦¦¦¦¦¦¦¦¦¦¦¦¦¦¦¦¦¦¦¦¦¦¦¦¦¦¦¦¦¦¦¦¦¦¦¦¦¦¦¦¦¦¦¦¦¦¦¦¦¦¦¦¦¦¦¦¦¦¦¦¦¦¦¦¦¦