▓▓▓▓▓▓▓▓▓▓▓▓▓▓▓▓▓▓▓▓▓▓▓▓▓▓▓▓▓▓▓▓▓▓▓▓▓▓▓▓▓▓▓▓▓▓▓▓▓▓▓▓▓▓▓▓▓▓▓▓▓▓▓▓▓▓▓▓▓▓▓▓▓▓▓▓▓▓▓▓▓▓▓▓▓▓▓▓▓▓▓▓▓▓▓▓▓▓▓▓▓▓▓▓
S          ▓▓                                       ▓                                               ▓▓ ▓
▓▓▓▓▓▓▓▓▓▓ ▓▓ ▓▓▓▓▓▓▓▓▓▓▓▓▓▓▓▓▓▓▓▓▓▓▓▓▓▓▓▓▓▓▓▓▓▓▓▓▓ ▓▓▓▓▓▓▓▓▓▓▓▓▓▓▓▓▓▓▓▓▓▓▓▓▓ ▓▓▓▓▓▓▓▓▓▓▓▓▓▓▓▓▓▓▓▓▓ ▓▓ ▓
▓                             ▓ ▓▓▓▓▓▓                                        ▓▓                 ▓▓ ▓▓ ▓
▓ ▓▓▓▓▓▓▓▓▓▓▓▓▓▓▓▓▓▓▓▓▓▓▓▓▓▓▓ ▓        ▓▓▓▓▓▓▓▓▓▓▓▓▓▓▓▓▓▓▓▓▓▓▓▓▓▓▓▓▓▓▓▓▓▓▓▓▓▓▓▓▓ ▓▓▓▓▓▓▓▓▓▓▓▓▓▓▓ ▓▓ ▓▓ ▓
▓      ▓  ▓                  ▓ ▓▓▓▓▓▓▓▓▓▓                                        ▓▓   ▓   ▓   ▓▓ ▓▓ ▓▓ ▓
▓ ▓▓▓▓▓▓ ▓▓ ▓▓▓▓▓▓▓▓▓▓▓▓▓▓▓▓ ▓ ▓▓▓▓▓▓▓▓▓▓ ▓▓▓▓▓▓▓▓▓▓▓▓▓▓▓▓▓▓▓▓▓▓▓▓▓▓▓▓▓▓▓▓▓▓▓▓▓▓▓▓▓ ▓   ▓   ▓    ▓▓ ▓  ▓
▓           ▓▓            ▓▓ ▓                         ▓ ▓▓                       ▓ ▓▓▓▓▓▓▓▓▓▓▓▓▓▓▓ ▓ ▓▓
▓▓▓▓▓▓▓▓▓▓▓▓▓▓ ▓ ▓▓▓▓▓▓▓▓▓▓▓ ▓▓▓▓▓▓▓▓▓▓▓ ▓▓ ▓▓▓▓▓▓▓▓▓ ▓▓    ▓▓▓▓▓▓▓▓▓▓▓▓▓▓▓▓▓▓▓ ▓      ▓            ▓ ▓▓
▓              ▓                         ▓▓          ▓▓▓▓▓▓▓▓▓▓▓▓▓▓▓▓▓▓         ▓▓▓▓▓▓▓▓ ▓▓▓▓▓▓▓▓▓▓ ▓ ▓▓
▓▓▓▓▓▓▓▓▓▓▓▓▓▓▓▓▓▓▓▓▓▓▓▓▓▓▓▓▓▓▓▓▓▓▓▓▓▓▓▓▓▓▓▓▓▓▓▓▓▓▓▓▓▓▓              ▓▓ ▓▓▓▓ ▓▓▓▓▓▓      ▓▓         ▓ ▓▓
▓                                                       ▓▓▓▓▓▓▓▓▓▓▓▓ ▓▓▓▓▓▓▓▓▓▓▓▓   ▓▓▓▓▓▓▓▓▓▓▓▓▓▓▓   ▓▓
▓ ▓▓▓▓▓▓▓▓▓▓▓▓▓▓▓▓▓▓▓▓▓▓▓▓▓▓▓▓▓▓▓▓▓▓▓▓▓▓▓▓▓▓▓▓▓▓▓▓▓▓▓▓▓▓           ▓              ▓▓ ▓ ▓           ▓▓▓▓▓
▓             ▓   ▓             ▓                        ▓▓▓▓▓▓▓▓▓  ▓▓▓▓▓▓▓▓▓▓▓▓▓▓       ▓▓▓▓▓▓▓▓▓     ▓
▓▓▓▓▓▓▓▓▓▓▓▓▓ ▓ ▓ ▓ ▓ ▓▓▓▓▓▓▓▓▓ ▓ ▓▓▓▓▓▓▓▓▓▓▓▓▓▓▓▓▓▓▓▓▓▓▓         ▓                ▓▓▓ ▓▓▓▓▓▓▓▓   ▓▓▓▓ ▓
▓   ▓       ▓ ▓ ▓ ▓ ▓          ▓               ▓▓▓▓▓▓▓▓▓▓ ▓▓▓▓▓▓▓▓ ▓▓▓▓▓▓▓▓▓▓▓▓▓▓▓▓   ▓         ▓    ▓ ▓
▓ ▓▓▓ ▓▓▓▓ ▓▓   ▓ ▓ ▓▓▓▓▓▓▓▓▓▓▓▓ ▓▓▓▓▓▓▓▓▓▓▓▓▓▓▓                                   ▓▓   ▓▓ ▓▓▓▓▓▓▓▓▓ ▓ ▓
▓     ▓     ▓ ▓▓▓ ▓                              ▓▓▓▓▓▓▓▓▓▓▓▓▓▓▓▓▓▓▓▓▓▓▓▓▓▓▓▓▓▓▓▓▓ ▓▓ ▓▓▓▓      ▓   ▓  ▓
▓▓▓ ▓▓▓▓▓▓▓▓▓ ▓ ▓ ▓▓▓▓▓▓▓▓▓▓▓▓▓▓▓▓▓▓▓▓▓▓▓▓▓▓▓▓▓▓▓▓▓                    ▓▓        ▓ ▓▓ ▓▓▓▓▓▓▓▓▓ ▓ ▓▓  ▓▓
▓   ▓           ▓                                   ▓▓▓▓▓▓▓▓▓▓▓▓ ▓▓ ▓▓ ▓▓▓▓▓▓▓▓▓ ▓ ▓          ▓ ▓ ▓▓ ▓▓▓
▓ ▓▓▓ ▓▓▓▓▓▓▓ ▓ ▓▓▓▓▓▓▓▓▓▓▓▓▓▓▓▓▓▓▓▓▓▓▓▓▓▓▓▓▓▓▓▓▓▓▓▓▓           ▓ ▓ ▓▓ ▓▓ ▓▓▓▓   ▓ ▓ ▓▓▓▓▓▓ ▓ ▓ ▓ ▓▓   ▓
▓     ▓   ▓   ▓                              ▓▓       ▓▓▓▓▓▓▓▓▓ ▓ ▓ ▓▓ ▓▓      ▓ ▓ ▓ ▓      ▓ ▓ ▓ ▓▓ ▓ ▓
▓ ▓▓▓▓▓▓▓ ▓ ▓ ▓▓▓▓▓▓▓▓▓▓▓▓▓▓▓▓▓▓▓▓▓▓▓▓▓▓▓▓▓▓ ▓▓ ▓▓▓▓▓       ▓▓▓ ▓ ▓ ▓▓ ▓▓▓▓▓▓▓▓▓ ▓ ▓ ▓▓▓▓▓▓▓  ▓   ▓▓ ▓ ▓
▓ ▓ ▓   ▓   ▓              ▓                      ▓   ▓▓▓▓▓ ▓▓▓ ▓ ▓  ▓ ▓▓       ▓▓ ▓ ▓     ▓ ▓▓▓▓▓▓▓ ▓ ▓
▓ ▓   ▓  ▓▓▓▓▓▓▓▓▓▓▓▓▓▓▓▓▓▓▓▓▓▓▓▓▓▓▓▓▓▓▓▓▓▓▓▓▓▓▓▓▓▓▓▓▓▓▓▓▓▓  ▓▓ ▓ ▓▓ ▓ ▓▓ ▓▓▓▓▓▓▓▓ ▓▓▓ ▓▓▓ ▓         ▓ ▓
▓ ▓▓▓ ▓▓                    ▓                             ▓▓  ▓ ▓ ▓▓ ▓ ▓▓              ▓ ▓ ▓▓▓▓▓▓▓▓▓▓▓ ▓
▓ ▓   ▓▓▓▓ ▓▓▓▓▓▓▓▓▓▓▓▓▓▓▓▓ ▓ ▓ ▓▓▓▓▓▓▓▓▓▓ ▓▓▓▓▓▓▓▓▓▓▓▓▓▓  ▓▓ ▓ ▓ ▓▓ ▓ ▓▓▓▓▓▓▓▓▓▓▓▓▓▓▓▓▓ ▓ ▓           ▓
▓ ▓ ▓▓▓                   ▓ ▓ ▓ ▓        ▓              ▓▓   ▓▓     ▓▓                   ▓ ▓ ▓▓▓▓▓▓▓▓▓▓▓
▓ ▓   ▓▓▓▓▓▓▓▓▓▓▓▓▓▓▓▓▓▓▓ ▓▓  ▓   ▓▓▓▓▓▓▓▓▓▓▓▓▓▓▓▓▓▓▓▓▓   ▓▓▓▓▓▓▓▓▓▓▓▓▓▓▓▓▓▓▓▓▓▓▓▓▓▓▓▓▓▓▓▓ ▓ ▓         E
▓   ▓                   ▓    ▓ ▓▓                      ▓▓                                  ▓   ▓ ▓▓▓▓▓▓▓
▓▓▓▓▓▓▓▓▓▓▓▓▓▓▓▓▓▓▓▓▓▓▓▓▓▓▓▓▓▓▓▓▓▓▓▓▓▓▓▓▓▓▓▓▓▓▓▓▓▓▓▓▓▓▓▓▓▓▓▓▓▓▓▓▓▓▓▓▓▓▓▓▓▓▓▓▓▓▓▓▓▓▓▓▓▓▓▓▓▓▓▓▓▓▓▓▓▓▓▓▓▓▓▓